wwwwwwwwwwwwwwwww
w cw  x   x  wc w
w     x   x     w
wwwwxxx   xxxwwww
w               w
wxxxxxxwwwxxxxxxw
w       w       w
wxxxxxxwwwxxxxxxw
w               w
wwwwxxx   xxxwwww
w     x   x     w
w cw  x   x  wc w
wwwwwwwwwwwwwwwww